###############################################################################################################################################################################################################################################################################
###############################################################################################################################################################################################################################################################################
###############################################################################################################################################################################################################################################################################
###.###########################################################################################################################################################################################################################################################################
###############################################################################################################################################################################################################################################################################
#.#############################################################################################################################################################################################################################################################################
################..........................................................................................#...............................................................................................................#####################################################
################..........................................................................................#...............................................................................................................#####################################################
######.#########..........................................................................................#...............................................................................................................#####################################################
.###############............................................$.............................................#...................................................................................................................................................................#
##########.#####...........!.............................######...........................................########............................................................................................................................................................#
#######.########.........####......................................########..###...................###........................................................................................................................................................................#
####.###########...@..###################.....!.........*.......&.#########..#####...............#####........................................................................................................................................................................#
###############################################################################################################################################################################################################################################################################
###############################################################################################################################################################################################################################################################################
#######.#######################################################################################################################################################################################################################################################################
###############################################################################################################################################################################################################################################################################
###############################################################################################################################################################################################################################################################################
###############################################################################################################################################################################################################################################################################
###############################################################################################################################################################################################################################################################################
###############################################################################################################################################################################################################################################################################