################################################################################################################################################################################################################################################################
################################################################################################################################################################################################################################################################
################################################################################################################################################################################################################################################################
################################################################################################################################################################################################################################################################
################################################################################################################################################################################################################################################################
################################################################################################################################################################################################################################################################
################################################################################################################################################################################################################################################################
################################################################################################################################################################################################################################################################
################################################################################################################################################################################################################################################################
################################################################################################################################################################################################################################################################
################################################################################################################################################################################################################################################################
################################################################################################################################################################################################################################################################
################################################################################################################################################################################################################################################################
################################################################################################################################################################################################################################################################
################################################################################################################################################################################################################################################################
#                                                                                                 #                                                                                                                                                            #
#           !                             ######        *                                  ########                                                                                                                                                            #
#         ####     !  !                             ########  ###                   ###                                                                                                                                                                        #
#@     ###################          *          &   #########  #####  !  !  *      #####     &  !                                                                                                                                                              $#
################################################################################################################################################################################################################################################################
################################################################################################################################################################################################################################################################
################################################################################################################################################################################################################################################################
################################################################################################################################################################################################################################################################
################################################################################################################################################################################################################################################################
################################################################################################################################################################################################################################################################
################################################################################################################################################################################################################################################################
################################################################################################################################################################################################################################################################
################################################################################################################################################################################################################################################################
################################################################################################################################################################################################################################################################
################################################################################################################################################################################################################################################################
################################################################################################################################################################################################################################################################
################################################################################################################################################################################################################################################################
################################################################################################################################################################################################################################################################