#################################################################################################################################################################################################################################################################################################################
#################################################################################################################################################################################################################################################################################################################
#################################################################################################################################################################################################################################################################################################################
#################################################################################################################################################################################################################################################################################################################
#################################################################################################################################################################################################################################################################################################################
#################################################################################################################################################################################################################################################################################################################
#################################################################################################################################################################################################################################################################################################################
###.#############################################################################################################################################################################################################################################################################################################
#################################################################################################################################################################################################################################################################################################################
#.###############################################################################################################################################################################################################################################################################################################
################..........................................................................................#..................................................................###############.................................................................................####################################
################.....*....................................................................................#...............................*.!..................................##########.....*..........................................................*....................###################################
######.#########..........................................................................................#.................................#########...........................######....................................................................#######................################################
.###############......................*....................*..............................................#.!...........................#..###########............................##..................................................................###.......###..............#################################
##########.#####.........................................######...........................*...............###########.....*......&.........#####..#####.............*..............#................................................................##.......$.....#.............#################################
#######.########.........####..&...................................########..###.......&...........###................................#....####....#####.....................................................&.................!..........................................*......#################################
####.###########...@..###################.....!.........*!........#########..#####...............#####..!..............##.......#.........####....!..................#####...#...!...................*.#######################################.......................#############################################
#################################################################################################################################################################################################################################################################################################################
#################################################################################################################################################################################################################################################################################################################
#######.#########################################################################################################################################################################################################################################################################################################
#################################################################################################################################################################################################################################################################################################################
#################################################################################################################################################################################################################################################################################################################
#################################################################################################################################################################################################################################################################################################################
#################################################################################################################################################################################################################################################################################################################
#################################################################################################################################################################################################################################################################################################################