################################################################################################################################################################################################################################################################
################################################################################################################################################################################################################################################################
################################################################################################################################################################################################################################################################
################################################################################################################################################################################################################################################################
################################################################################################################################################################################################################################################################
################################################################################################################################################################################################################################################################
################################################################################################################################################################################################################################################################
################################################################################################################################################################################################################################################################
################################################################################################################################################################################################################################################################
################################################################################################################################################################################################################################################################
################################################################################################################################################################################################################################################################
################################################################################################################################################################################################################################################################
################################################################################################################################################################################################################################################################
################################################################################################################################################################################################################################################################
################################################################################################################################################################################################################################################################
#                                                                                                                                                                                                                                                              #
#                                                                                                                                                                                                                                                              #
#                                                                                                                                                                                                                                                              #
#@                                                                                                                                                                                                                                                             #
################################################################################################################################################################################################################################################################
################################################################################################################################################################################################################################################################
################################################################################################################################################################################################################################################################
################################################################################################################################################################################################################################################################
################################################################################################################################################################################################################################################################
################################################################################################################################################################################################################################################################
################################################################################################################################################################################################################################################################
################################################################################################################################################################################################################################################################
################################################################################################################################################################################################################################################################
################################################################################################################################################################################################################################################################
################################################################################################################################################################################################################################################################
################################################################################################################################################################################################################################################################
################################################################################################################################################################################################################################################################
################################################################################################################################################################################################################################################################